222222222222222222222222222222222222222222222222222222222424222222242222222222222224242222222222222222222222222222222222222222222224242224242424242424222222222222222222222222222222242224242222242424242222222222222222222222222222222222222222
222222222222222222222222222222222222222424222222222222222424222224242222222222222224242222222224242224242222222222222222222222222224242424242424242424222224222222222222222424222224242224242222242424242224242222222222242422242422222222222222
222424222222222222222222222224242222222424222222222224242424222224242222222222242424242222222224242224242222242222222424222222242424242424242424242424222224242222222424222424222224242224242222242424242224242222222224242422242422222222222222
222424222224242222222222222224242224242424222222222224242424222224242222222222242424242224242224242224242222242222222424222222242424242424242424242424222224242222222424222424222224242224242222242424242224242222222424242422242422222224242422
222424222224242222222222222224242224242424222222242424242424222224242224242222242424242224242224242224242222242222222424222222242424242424242424242424222224242222222424222424222224242224242224242424242224242424242424242422242422222224242422
222424222224242422222222242424242224242424222222242424242424222224242224242222242424242224242224242224242424242222222424222222242424242424242424242424222224242222222424222424222224242224242224242424242424242424242424242424242422222224242422
242424242424242424242424242424242424242424242424242424242424242424242424242424242424242424242424242424242424242424242424242424242424242424242424242424242424242424242424242424242424242424242424242424242424242424242424242424242424242424242424
404040404040404040404040404040404040404040404040404040404040404040404040404040404040404040404040404040404040404040404040404040404040404040404040404040404040404040404040404040404040404040404040404040404040404040404040404040404040404040404040
404040404040404040404040404040404040404040404040404040404040404040404040404040404040404040404040404040404040404040404040404040404040404040404040404040404040404040404040404040404040404040404040404040404040404040404040404040404040404040404040
404040404040402020202020202020202020202020202020202020202020202020202020062020202020202020202020404020202020202020202020404040404040404040404020202006202040404020202020204040402020202020202020202020202020202020202020204020202020202929292929
202020202020202020202020202020202020202020202020202020202020202020202020202020202020404040404040404020202020202020202020202020202020202020204040402020202040404020202020202020202020202040404040404020202020202020202020204020202020204040404040
202020202020202020202020404040404040404040404040404040404040404040404040404020202020202020202020202020202020404020202020202020202020202020204040402020202040404020202020202020202020202020062020204020202020202020202020204020202020202929292929
404040404040402020202020202020202020202020202020202020202020202020202020204020202020202020202020202020202020404020202020404040404040202020204040402020202040404020202040404040404020202020202020204020204040404040404040404020202020204040404040
404040404040402020202020202020202020202020202020202020202020202020202020204020202020202040404040404040404040404020202020404040404040202020202020202020202020202020202040402020202020202040404040204020202020202020202020202020202020202929292929
404040404040404040404040404040404040404040404040404040404040404040404040404040404040404040404040404040404040404040404040404040404040404040404040404040404040404040404040404040404040404040404040404040404040404040404040404040404040404040404040
404040404040404040404040404040404040404040404040404040404040404040404040404040404040404040404040404040404040404040404040404040404040404040404040404040404040404040404040404040404040404040404040404040404040404040404040404040404040404040404040
