232323232323232323232323232323232323232323232323232323232323232323232323232323232323232323232323232323232323232323232323232323232323232323232323232323232323232323232323232323232323232323232323232323232323232323232323232323232323232323232323
232323232323232323232323232323232323232323232318192323232323232323232323232323232323232323232323232323232323232323232323232323232323232323232323232323232323232323232323232323232323232323232323232323232323232323232323232323232323232323232323
2323232323232323232323232323232323232323232323231623232323232323232323232323232323232323232323232323232323231a1b23232323232323232823282328232823232323232323232323232323232323232323232323232323232323232323232323232323181923231a1b232323232323
232318192323232323232323232323232323232327272727272727232323232323232323232323232323232323232323232323232323231623232323232323232828282828282823232323232323272727272727272727272727232323232323232323232323232323232323231623232317232323232323
232323172323232323232727272723232323232325252525252525232323232327272727272727272323232323232325252323232327272727272723232323232828282828022823232323232121212121212121212121212121212121232323232323232323232323232121212121212121232323232321
272727272727272727272727272727272727272727272727272727272727272727272727272727272727272727272727272727272727272727272727272727272727272727272727272727272727272727272727272727272727272727272727272727272727272727272727272727272727272727272727
252525252525252525252525252525252525252525252525252525252525252525252525252525252525252525252525252525252525252525252525252525252525252525252525252525252525252525252525252525252525252525252525252525252525252525252525252525252525252525252525
252525252525252525252525252525252525252525252525252525252525252525252525252525252525252525252525252525252525252525252525252525252525252525252525252525252525252525252525252525252525252525252525252525252525252525252525252525252525252525252525
252525252525252525252525252525252525252525252525252525252525252525252525252525252525252525252525252525252525252525252525252525252525252525252525252525252525252525252525252525252525252525252525252525252525252525252525252525252525252525252525
21212121212121212121212121212121212525252525252525252525252525252521212121212121212107212121212521212121212121212121212121212121212121212125252525252121212121212121212121212121212121212121252121212121212525252525252525212121212121212a2a2a2a
2121212121210721252525252521212121252121212121212121212121212121212121434343434321212121212121252121212143434343432121212121212143212121252525252525212121212143434343434343434321212121212125212121212121252121212121252121212121212121212a2a2a
212121212121212121252525252525252525212121212121212121212121212121212143212121212121212121212121212121434343434343432121212121214321212121252525252521212121212121212121212121212121432121212521212121212125212121212125212121214321212121212a2a
434343434321212121212121212121212121212121432121212143434343434343434343212121212121212121212121212121212121212143434321212121214321212121072125252521212121212121212121212121212121432121212121212521212121212125252525212121214343212121212121
434343434321212121212121212121212121212121432121212121212121212121212121212121434343434343434343434343434343434343434343434343434343212121212121212121212143432121212121434343434343432121212121212521212121212121212121212121214343432121212121
434343434343434343434343434343434343434343434343434343434343434343434343434343434343434343434343434343434343434343434343434343434343434343434343434343434343434343434343434343434343434343434343434343434343434343434343434343434343434343434343
434343434343434343434343434343434343434343434343434343434343434343434343434343434343434343434343434343434343434343434343434343434343434343434343434343434343434343434343434343434343434343434343434343434343434343434343434343434343434343434343
