232323232323232323232323232323232323232323232323232323232525232323252323232323232325252323232323232323232323232323232323232323232325252325252525252525232323232323232323232323232323252325252323252525252323232323232323232323232323232323232323
232323232323232323232323232323232323232525232323232323232525232325252323232323232325252323232325252325252323232323232323232323232325252525252525252525232325232323232323232525232325252325252323252525252325252323232323252523252523232323232323
232525232323232323232323232325252323232525232323232325252525232325252323232323252525252323232325252325252323252323232525232323252525252525252525252525232325252323232525232525232325252325252323252525252325252323232325252523252523232323232323
232525232325252323232323232325252325252525232323232325252525232325252323232323252525252325252325252325252323252323232525232323252525252525252525252525232325252323232525232525232325252325252323252525252325252323232525252523252523232325252523
232525232325252323232323232325252325252525232323252525252525232325252325252323252525252325252325252325252323252323232525232323252525252525252525252525232325252323232525232525232325252325252325252525252325252525252525252523252523232325252523
232525232325252523232323252525252325252525232323252525252525232325252325252323252525252325252325252325252525252323232525232323252525252525252525252525232325252323232525232525232325252325252325252525252525252525252525252525252523232325252523
252525252525252525252525252525252525252525252525252525252525252525252525252525252525252525252525252525252525252525252525252525252525252525252525252525252525252525252525252525252525252525252525252525252525252525252525252525252525252525252525
414141414141414141414141414141414141414141414141414141414141414141414141414141414141414141414141414141414141414141414141414141414141414141414141414141414141414141414141414141414141414141414141414141414141414141414141414141414141414141414141
414141414141414141414141414141414141414141414141414141414141414141414141414141414141414141414141414141414141414141414141414141414141414141414141414141414141414141414141414141414141414141414141414141414141414141414141414141414141414141414141
414141414141412121212121212121212121212121212121212121212121212121212121072121212121212121212121414121212121212121212121414141414141414141414121212107212141414121212121214141412121212121212121212121212121212121212121214121212121212a2a2a2a2a
212121212121212121212121212121212121212121212121212121212121212121212121212121212121414141414141414121212121212121212121212121212121212121214141412121212141414121212121212121212121212141414141414121212121212121212121214121212121212121212121
212121212121212121212121414141414141414141414141414141414141414141414141414121212121212121212121212121212121414121212121212121212121212121214141412121212141414121212121212121212121212121072121214121212121212121212121214121212121212a2a2a2a2a
414141414141412121212121212121212121212121212121212121212121212121212121214121212121212121212121212121212121414121212121414141414141212121214141412121212141414121212141414141414121212121212121214121214141414141414141414121212121212121212121
414141414141412121212121212121212121212121212121212121212121212121212121214121212121212141414141414141414141414121212121414141414141212121212121212121212121212121212141412121212121212141414141214121212121212121212121212121212121212a2a2a2a2a
414141414141414141414141414141414141414141414141414141414141414141414141414141414141414141414141414141414141414141414141414141414141414141414141414141414141414141414141414141414141414141414141414141414141414141414141414141414141414141414141
414141414141414141414141414141414141414141414141414141414141414141414141414141414141414141414141414141414141414141414141414141414141414141414141414141414141414141414141414141414141414141414141414141414141414141414141414141414141414141414141
