232323232323232323232323232323232323232323232323232323232323232323232323232323232323232323232323232323232323232323232323232323232323232323232323232323232323232323232323232323232323232323232323232323232323232323232323232323232323232323232323
232323232323232323232323232323232323232323232323232323232323232323232323232323232323232323232323232323212121212123232323232323232323232323232323232323232323232323232325232323232323232323232323232323232323232323232323232323232323232323232323
232323232323232323232323232323232323232323232323232323232323232323232323232323232323232323232323232321212121212123232323232323232323232323232323232323232323232324242424242424242323232323232323232323232323232323232323232323232323232323232323
232323232323232323232424242424242424242424242424242323232323232323232323232323232323232121212121212121212121212123232323232323232323232323232323232323232323232324242424242424242323232323232323232323232323232323242424242424232323232323232323
232323232323232323232424242324232423242324242424242323232323232323232323232323232323232121212121212121212121212123232323232323232323232323232323232323232323232324232424242424242424242424242323232323232323232323242423242324232323232323232323
2323232323232323232324242424242424242424242424242423232323231819232323232323232323232321232123212321232123212321232318192323232323232323232323232323231a1b23232324242424242323242424242424242323232323232323232323242424242424232323232323232323
232323232323232323232424242323232323232324242425242323232323231523232323232323232323232125212121212121212121212123232316232323232323232323232323232323231623232324252424242323242323242323242323232323232323232323242424242524232323232323232323
424242424242424242424242424242424242424242424242424242424242424242424242424242424242424242424242424242424242424242424242424242424242424242424242424242424242424242424242424242424242424242424242424242424242424242424242424242424242424242424242
424242424242424242424242424242424242424242424242424242424242424242424242424242424242424242424242424242424242424242424242424242424242424242424242424242424242424242424242424242424242424242424242424242424242424242424242424242424242424242424242
4242424242424242424242424242424242424242222222224242424242424242424242424242424242424222222222422222222222222242422222222222222242424242424242424242422222222207222242224222222222222222424222222222424242222222422222224242424242424242422a2a2a
222222222222222222224242222222222222424222222222424222224242424222224242222222222222222222222242222222224242424242222222222222224242424242424242424242222222222222224222424242424242222242422222222242424222222242222222424242424242424242424242
2222222222222222222242422222222222224242424242424242222222424242424242424242424242424242424242424242424222222222422222224242424222224242222222422222224242424242424242224242424242424242424242222222424242222222422222224242424242424242422a2a2a
222222222222222222224242222222222222424222222222424222222222222242422222222222222222222222224242424242422222222242220722424242422222424222222222222222424222222242422222224222224a4b222222222242424222222222222242424242222222222222222222222222
4242424242424242424242424242424242424242222222224242424222222222424222222222224c4c22222222224242424242422222222242222222424242422222424222222242222222424222222242422222224222224849222222222222224222222242424242424242222222222222222222222222
424242424242424242424242424242424242424242424242424242424242424242424242424242424242424242424242424242424242424242424242424242424242424242424242424242424242424242424242424242424242424242424242424242424242424242424242424242424242424242424242
424242424242424242424242424242424242424242424242424242424242424242424242424242424242424242424242424242424242424242424242424242424242424242424242424242424242424242424242424242424242424242424242424242424242424242424242424242424242424242424242
