2323232323232323232323232323232323232323232323232323232323232323232323232323232323232323232323232323232323232323232323232323232323232323232323232323232323232323232323232323232323232323232323232323232323232323232323232323232323232323232323232323232323232323232323232323232323232323232323232323232323232323232323232323232323232323232323232323232323232323232323232323232323232323232323232323232323232323
2323232323232323232323232323232323232323232323232323232323232323232323232323232323232323232323232323232323232323232323232323232323232323232323232323232323232323232323232323232323232323232323232323232323232323232323232323232323232323232323232323232323232323232323232323232323232323232323232323232323232323232323232323232323232323232323232323232323232323232323232323232323232323232323232323232323232323
2323232323232323232323232323232323232323232323232323232323232323232323232323232323232323232323232323232323232323232323232323232323232323232323232323232323232323232323232323232323232323232323232323232323232323232323232323232323232323252325252523232323232323232323232323232323232323232323232323232323232323232323232525252323232323232323232323232323232323232323232323232323232323232323232323232323232323
2323232323232323232323232323232323232323232323232323232323232323232323232323232323232323232323232323232323232323232323232323232323232323232323252525232323232323232323232323232323232323232323232525232323232323232323232323232323232525252325252523232323232525232323232523232323232323232323232323232323232323232323232525252325232323232323232323232323232323232323232323232323232323232323232323232323232323
2323232323232323232323232323232323232323232323232323232323232323232323232323232323232323232323232323232323232323232323232323232323232323252525252525232323232323232323232323232323232323232523232525252523232323232323232323232525232525252325252523232323232525232525252523232523232323232323232323232323232323232325252525252325252523232323232323232323232323232323232323232325252323232323232323232323252525
2323232323232323232323232323232323232323232323232323232323232323232323232323232323232323232323232323232323232323232323232323232323232323252525252525252323232323232323232323232323232323252523232525252523232323232323232323252525232525252325252523252525232525232525252523232525232323232323232323232323232323232325252525252325252525232323232323232323232323232323232525232325252323232525232323232323252525
2323232323232323232323232323232323232323232323232323232325252323232523232323232323252523232323232323232323232323232323232323232323252523252525252525252323232323232323232323232323232523252523232525252523232323232323232323252525232525252325252523252525232525232525252523232525232523232323232323232323232323252325252525252325252525232323232323232323232323232323232525232325252323232525252323252323252525
2323232323232323232323232323232323232325252323232323232325252323252523232323232323252523232323252523252523232323232323232323232323252525252525252525252323252323232323232325252323252523252523232525252523232523232323232323252525232525252325252523252525232525232525252523232525232525232323232323232323232525252325252525252325252525232325232323232323232323252523232525232325252323232525252323252323252525
2325252323232323232323232323252523232325252323232323252525252323252523232323232525252523232323252523252523232523232325252323232525252525252525252525252323252523232325252325252323252523252523232525252523232525232323252523252525232525252325252523252525232525232525252523232525232525232323232323232323232525252325252525252325252525232325252323232323232525252523232525232325252323232525252323252323252525
2325252323252523232323232323252523252525252323232323252525252323252523232323232525252523252523252523252523232523232325252323232525252525252525252525252323252523232325252325252323252523252523232525252523232525232525252523252525232525252325252523252525232525232525252523232525232525232323232323252523252525252325252525252325252525232325252323252523232525252523232525232325252323232525252323252323252525
2325252323252523232323232323252523252525252323232525252525252323252523252523232525252523252523252523252523232523232325252323232525252525252525252525252323252523232325252325252323252523252523252525252523232525232525252523252525232525252325252523252525232525232525252523232525232525232325232323252523252525252325252525252325252525232325252323252523232525252523232525232325252323232525252323252323252525
2325252323252525232323232525252523252525252323232525252525252323252523252523232525252523252523252523252525252523232325252323232525252525252525252525252323252523232325252325252323252523252523252525252523232525232525252523252525232525252325252523252525232525232525252523232525232525232325252523252523252525252325252525252325252525232325252323252523232525252523232525232325252323232525252323252323252525
2525252525252525252525252525252525252525252525252525252525252525252525252525252525252525252525252525252525252525252525252525252525252525252525252525252525252525252525252525252525252525252525252525252525252525252525252525252525252525252525252525252525252525252525252525252525252525252525252525252525252525252525252525252525252525252525252525252525252525252525252525252525252525252525252525252525252525
2121212121212121212121212121212121212121212121212121212121212121212121212121212121212121212121212121212121212121212121212121212121212121212121212121212121212121212121212121212121212121212121212121212121212121212121212121212121212121212121212121212121212121212121212121212121212121212121212121212121212121212121212121212121212121212121212121212121212121212121212121212121212121212121212121212121212121
2121212121212121212121212121212121212121212121212121212121212121212121212121212121212121212121212121212121212121212121212121212121212121212121212121212121212121212121212121212121212121212121212121212121212121212121212121212121212121212121212121212121212121212121212121212121212121212121212121212121212121212121212121212121212121212121212121212121212121212121212121212121212121212121212121212121212121
2121212121212121212121212121212121212121212121212121212121212121212121212121212121212121212121212121212121212121212121212121212121212121212121212121212121212121212121212121212121212121212121212121212121212121212121212121212121212121212121212121212121212121212121212121212121212121212121212121212121212121212121212121212121212121212121212121212121212121212121212121212121212121212121212121212121212121
