232323232323232323232323232323232323232323232323232323232323232323232323232323232323232323232323232323232323232323232323232323232323232323232323232323232323232323232323232323232323232323232323232323232323232323232323232323232323232323232323
232323232323232323232323232323232323232323232323232323232323232323232323232323232323232323232323232323232323232323232323232323232323232323232323232323232323232323232323232323232323232323232323232323232323232323232323232323232323232323232323
232323232323232323232323232323232323232323232323232323232323234848232323232323232323232323232348482323232323232323232323232348482348482348482323232323232323484823484823232323232323232323234848234848234848232323232323232323232323234848232323
232323482348482348232323232323232323232323232323232323484848234848232323232323232323232323232348482323232323232323232323232348484848484848482323232323232323484848484823232323232323232323234848484848484848232323232323232323232323234848232323
232323484848484848232323232323232323232323232323232348484848484848232323232323232323232323232348482323232323232323232323232348484848484848482323232323232323484848484823232323232323232323234848484848484848232323232323232323232323234848232323
232323484848484848232323232323232323232323232323232348484848484848232323232323232323232323232348482323232323232323232323232348484848484848482323232323232323484848484823232323232323232323234848484848484848232323232323232323232323234848232323
262626262626262626262626262626262626262626262626262626262626262626262626262626262626262626262626262626262626262626262626262626262626262626262626262626262626262626262626262626262626262626262626262626262626262626262626262622222222222222222222
222222222222222222222222222221212121212121212121212121212121212121212121212121212122222221212121212121212121212121212121212121212122222121212121212121212121212121212121210721212121212121212122222222222222212121212121212121212121212121212121
222222222222222222222222222221212121212121212121212121212121212121212121212121212122222221212121212121212121212121212121212121212122222121212121212121212122222222222222222222222222222121212122222222212121212121212121212121212121212121212121
222222222222222222222222222221212121212121222121212121222222222222222222222222222222222221212121212122222222222222222221212107212122222121212121212121212121212121212121212121222222222121212122222222212121212121212121212122222222222222222222
2121212121212121212121222222212107212121212221212121212121212121212121212121212122222121212121212121212121212121212222212121212122222222222121212121212121212121212121212121212222222221212121222222222121212121212121212121222222220a0a0a0a0a0a
212121212121212121212122222222212121212121222121212121212121212121212121212121212222212121212121212121212121212121222221212121212122222222212121212121222222212121212222222222222222222121212121222222212121222222222222222222222222222222222222
2222222222222121212121222222222121212121212222212121212121212121212121212121212122222121212121212222222222222222222222212121212121212222222121212121222222222121212122222222222222222222222121212222222121212222222222222222222222220a0a0a0a0a0a
222222222222222121212121212121212121212121222222212121212121212222222222222222222222212121212121212121212122222121212121212121212121212121212121212121212122212121212121212121212121212222212121212121212121212121212121212121212122222222222222
2222222222222222212121212121212121212121212222222221212121212121212121212121212121212121212121212121212121222221212121212121212121212121212121212121212121222121212121212121212121212122222121212121212121212121212121212121212121220a0a0a0a0a0a
222222222222222221212121212121212121212121222222222221212121212121212121212121212121212121212121212121212122222121212121212121212121212121212121212121212122212121212121212121212121212222212121212121212121212121212121212121212122222222222222
