23232323232323232323232323232323232323232323232323232323252523232325232323232323232525232323232323232323232323232323232323232323232525232525252525252523232323232323232323232323232325232525232325252525
23232323232323232323232323232323232323252523232323232323252523232525232323232323232525232323232525232525232323232323232323232323232525252525252525252523232523232323232323252523232525232525232325252525
23252523232323232323232323232525232323252523232323232525252523232525232323232325252525232323232525232525232325232323252523232325252525252525252525252523232525232323252523252523232525232525232325252525
23252523232525232323232323232525232525252523232323232525252523232525232323232325252525232525232525232525232325232323252523232325252525252525252525252523232525232323252523252523232525232525232325252525
23252523232525232323232323232525232525252523232325252525252523232525232525232325252525232525232525232525232325232323252523232325252525252525252525252523232525232323252523252523232525232525232525252525
23252523232525252323232325252525232525252523232325252525252523232525232525232325252525232525232525232525252525232323252523232325252525252525252525252523232525232323252523252523232525232525232525252525
25252525252525252525252525252525252525252525252525252525252525252525252525252525252525252525252525252525252525252525252525252525252525252525252525252525252525252525252525252525252525252525252525252525
21212121212121212121212121212121212121212121212121212121212121212121212121212121212121212121212121212121212121212121212121212121212121212121212121212121212121212121212121212121212121212121212121212121
21212121212121212121212121212121212121212121212121212121212121212121212121212121212121212121212121212121212121212121212121212121212145212121212121212121212121212121212121212121472121212121212121212121
21212121212121212121212121212121212121212121212121212121212148484848484848484848484848484848484848484848484848484848484848484848484845212121484848484848484848484848484848484848472121212121212121212121
21212121212121212121212121212121212121212121212121212121212148212121212121212121212121212148212121212121212121212121212121212121212145212121482121212121212121212121212121212121472121212121212121484821
21212148484848484848484848484848484848484848484848484848484848212121212121212121212121212148484848484848484848484848484821212121212121212121484848484848484848484848484848484848484848484848484848484821
21212121212121212121212121212121212121212121212121212121212148212121212121212121212121462121212121212121212121212121214821212121212121212121482121212121214721212121212121212121212121212121212121484821
21212121212121212121212121212121212121212121212121212121212148212121212121212121484848462121212121212121212121212121214848484848484848484848484848484848484721212121212121212121212121212121212121212121
21212121212121212121212121212121212121212121212121212121212148484848484848484848482121462121212121212121212121212121212121212121212121212121212121212121214721212121212121212121212121212121212121212121
21212121212121212121212121212121212121212121212121212121212121212121212121212121212121212121212121212121212121212121212121212121212121212121212121212121214721212121212121212121212121212121212121212121
