222222222222222222222525252522222222252525252525252525252522222225252525252525252222222222222222222222222525252525252222222525252525252222222222252525252525252222222525252525252525252222252522222222222222222222222222222222222222252525252525
222222222222252525252525252525252525252522222222222525252525252525222222222225252525252525252525252525252525252525252222222525252525252525252525252525252525252222222525222222222525252222252525252222222222222222222222222222222225252525252525
252525252525252525252525252525252525252522222222222525252525252525222222222243432525252525252525252525252525252525252525252525252525252525252525252525252525252525252525222222222525252525252525252525252525252222222222222222252525252525252525
252525252525252525252525252525252525252525252525252525252525252525252525254343432525252525252525252525252525252525252525252525252525252525252525252525252525252525252525252525252525252525252525252525252525252525252525252525252525252525252525
252525252525252525252525252525252525254343434343434343432525254343434325252525252525252525252525252525252525252525252525252543432525252525252525252525252525252525252525252525252525252525252525252525252525252525252525252525252525252525252525
252525252525434343434343434343434343434343434325254343434343434343432525252525252525252543434343434325252525252525252525252543432525252525252525434343434343434343434343434343434325252525252525252525252525252525252525252525252525252525252525
252525252525252525252525252525252525252525252525252525252525252525252525252525252525252525252525252525252525252525252525252525252525252525252525252525252525252525252525252525252525252525252525252525252525252525252525252525252525252525252525
4242424242424242424242424242424242424242424242424242424242424242424242424242424242424242424242424242424242424242424242424242424242222222222222222222224242424242424242424242424242424242424242424242424242424242424242424242424242424242422a2a2a
424242424242424242424242424242424242424242424242424242424242424242424242424242424242424242424242424242424222224242424242422222424222222222220722222222424242424242424242424242424222222242424242222242424242424242424242424242424242424242424242
4242424242424242424242424242424242424242424242424242424242424242424242424242424242424242424242424242424242222242424242424222224242424242424242424222224242424242424242424242424242222222424242422222424242422222424222224242424242424242422a2a2a
232323232323232323234242232342422323424242424242422323424242424242424242424242424242424242424242424242424242424242424242424242424242424242424242422222224242424242424242424242424242424242424242424242424242222242422222424242424242424242424242
2222222222222222222242422222424222224242424242424222224242424242424242424242424242424242424242424242424242424242422222224242424242424242424242424222222222424242424242424242424242424242424242424242424242422222424242424242424242424242422a2a2a
222222222222222222224242222242422222424242424242422222424242222242424222224242424242424222224242424242424242424242220722424242424242424242424242422222222222222222222222222222224242424242424242424222224242424242424242222222222222222222222222
222242222242424242424242424242424242424242424242424242424242222242424222224242424242424222224242424242424242424242222222424242424242424242424242422222222222222222222222222222224242424242424242424222224242424242424242222222222222222222222222
2222422222424242424242424242424242424242424242424242424242424242424242424242424242424242424242424242424242424242424242424242424242424242424242424242424242424242222222222222224a4b22222222222222224242424242424242424242424242424242424242424242
222242222242424242424242424242424242424242424242424242424242424242424242424242424242424242424242424242424242424242424242424242424242424242424242424242424242424222222222222222484922222222222222224242424242424242424242424242424242424242424242
