232323232323232323232323232323232323232323232323232323232525232323252323232323232325252323232323232323232323232323232323232323232325252325252525252525232323232323232323232323232323252325252323252525252323232323232323232323232323232323232323
232323232323232323232323232323232323232525232323232323232525232325252323232323232325252323232325252325252323232323232323232323232325252525252525252525232325232323232323232525232325252325252323252525252325252323232323252523252523232323232323
232525232323232323232323232325252323232525232323232325252525232325252323232323252525252323232325252325252323252323232525232323252525252525252525252525232325252323232525232525232325252325252323252525252325252323232325252523252523232323232323
232525232325252323232323232325252325252525232323232325252525232325252323232323252525252325252325252325252323252323232525232323252525252525252525252525232325252323232525232525232325252325252323252525252325252323232525252523252523232325252523
232525232325252323232323232325252325252525232323252525252525232325252325252323252525252325252325252325252323252323232525232323252525252525252525252525232325252323232525232525232325252325252325252525252325252525252525252523252523232325252523
232525232325252523232323252525252325252525232323252525252525232325252325252323252525252325252325252325252525252323232525232323252525252525252525252525232325252323232525232525232325252325252325252525252525252525252525252525252523232325252523
252525252525252525252525252525252525252525252525252525252525252525252525252525252525252525252525252525252525252525252525252525252525252525252525252525252525252525252525252525252525252525252525252525252525252525252525252525252525252525252525
242424242424242424242424242424242424242424242424242424242424242421212121212121212121212121212121242421212121212121212121212121212121242424242421212121212121212121212121212424242121212121212124242424242424242424242424242421212121212121212121
242424242424242121212121212121212121212121242121212124242424242421212121212121212121212121212121242421212121212121212121212121212121242424242421212121212121212121212121212424242121212121212124242424242424242424242424242421212121212121212121
242424242424242121212121212121212121212121242121212124242424242421212121072121212121212121212121242421212121242421212121242424242424242424242421212107212124242421212121212424242121212121212124212121212121212121212121212421212121212424242424
212121212121212121212121242424242424242424242121212124242424242424242121212121242424242424242424242421212121242421212121212121212121212121212424242121212124242421212121212121212121212124242424212121212121212121212121212421212121210a0a0a0a0a
212121212121212121212121242424242121212121212121212124212121212121212121212121212121212121242121212121212121242421212121212121212121212121212424242121212124242421212121212121212121212124242424212121212121212121212121212421212121212424242424
242424242424242121212121242424242121212121212121212124212121212121212121212121212121212121242121212121212121242421212121242424242424212121212424242121212124242424242424242424242421212124242424212121242424242424242424242421212121210a0a0a0a0a
242424242424242121212121242424242121212121212121212124212121212121212121212121212424242424242121212124242424242421212121242424242424212121212121212121212121212121212124242121212121212124242424212121212121212121212121212121212121212424242424
242424242424242121212121212121212121212124242121212121212121242424242421212121212121212121212121212124242424242421212121212121212124212121212121212121212121212121212124242121212121212121212121212121212121212121212121212121212121210a0a0a0a0a
242424242424242121212121212107212121212124242121212121212121242424242421212121212121212121212121212124242424242421212121212121212124212121212121212121212121212121212124242121212121212121212121212121242424242424242424242424242424242424242424
