484848484848484848484848484848484848484848484848484848484848484848484848484848484848484848484848484848484848484848484848484848484848484848484848484848484848484848484848484848484848484848484848484848484848484848484848484848484848484848484848
484848482323484848484848484848232323484848484848484848484848484848484848234848484848484848482323234848484848484823484848482323484848484848484848484848484848484848484848482121214848484848484848484848232323234848484848484848484823232348484848
484848484848484848232348484848484848484848482121212148482323234848484823232348484848484848484848484848484848484848484848484848484848212121484848482323484848484848484848212121214848484848484848484848482323484848484848212121484848234848484848
484848484848484848484848214848484848484821212121212121482323234821212148484848484848484848484848484848484848482148484848484848484821212121214848484848484848212121482121212121212121484848484848484848484848484848484821212121214848484848484848
484821214848484848482121212148484848484821212121212121484848484821212121212121214848232348484821214848484821212121212148484848482121212121212148484848482121212121212121212121212121212121484848484848484848484848482121212121212121484848484821
212121212121212121212121212121212121212121212121212121212121212121212121212121212121212121212121212121212121212121212121212121212121212121212121212121212121212121212121212121212121212121212121212121212121212121212121212121212121212121212121
242424242424242424242424242424242424242424242424242424242424242424242424242424242424242424242424242424242424242424242424242424242424242424242424242424242424242424242424242424242424242424242424242424242424242424242424242424242424242424242424
24242424242121212121212121212121212421212121212121212121242424242121212121212121212121212121242421212121212121212121212121212121212121212124242424242121212121212121212121212121242424242424242421212121212121212121212124212121212124240a0a0a0a
242424242421212121212121212121212124212121212121212121212424242421212121212121212107212121212424212121212121212121212121212121212121212121242424242421212121212121212121212121212121212121212424212121212121212121212121242121212121212424242424
2121212121212121212121212121212121242121212121212121212124242424212121212124242424242421212121242121212121242121212121212121212121212121212424242424212121212121242424242121212121212121212121242121212121242424242424242421212121212121240a0a0a
212121212121072124242424242121212124212121212421212121212121212121212124242424242121212121212124212121212424212121212121242421212121212424242424242421212107212424242424242424242424242121212121212121212124212121212124212121212121212121242424
21212121212121212124242424242424242421212121242121212121212121212121212421212124212121212121212121212124242424242421212124242121212121212121212124242121212121212121212121212121212124212121212121212121242421212121212421212121242121212121240a
242424242421212121212121212121212121212121242421212124242424242424242424212121242121212121212121212121212121212124212121242421212121212121212121242421212121212121212121212121212121242121212121212121212424212424242424212121212424212121212424
242424242421212121212121212121212121212121242421212124242424242424242424212121242424242421212121212121212121212124212121242424242424212121212124242421212124242121212121242424242424242121212121212121212121212121242424212121212424242121212424
242424242421212121212121212121212424242424242421212121212121212121212121212121212121212421212121212121212121212124212121242421212121212121212121212121212124242121212121212121212121242121212121212121212121212121212121212121212421212121212121
242424242421212121212121212121212424242424242421212121212121212121212121212121212121212424242424242424242424242424212121242421212121212121212121212121212124242121212121212121212121242121212424242121212121212121212121212121212421212121212121
